{
  "layout": [
[0, 0, 0, 0, 0, 0, 0, 0, 0, 0, 0, 0, 0, 0, 0, 0, 0, 0, 0, 0, 0], 
[0, 0, 0, 0, 0, 0, 0, 0, 0, 0, 0, 0, 0, 0, 0, 0, 0, 0, 0, 0, 0], 
[0, 0, 0, 0, 0, 0, 0, 0, 0, 0, 0, 0, 0, 0, 0, 0, 0, 0, 0, 0, 0], 
[0, 0, 0, -201, 1, 0, 1, -203, 4, -201, 104, -2, 201, -2, -1, -202, -201, -201, 0, 0, 0], 
[0, 0, 0, 3, 4, 103, -3, -201, 202, -1, -2, -203, -2, -1, -203, 102, -203, -3, 0, 0, 0], 
[0, 0, 0, -201, -3, -203, -203, -202, 203, -2, -202, -203, -202, 2, -3, -1, -3, -1, 0, 0, 0], 
[0, 0, 0, -3, -202, -202, -1, -202, 4, 4, 4, 100, -2, 105, -2, -3, -201, -1, 0, 0, 0], 
[0, 0, 0, 101, 1, 0, 1, 0, 0, 0, 0, 1, 1, 0, 0, 0, 1, 1, 0, 0, 0], 
[0, 0, 0, 0, 0, 0, 0, 0, 0, 0, 0, 0, 0, 0, 0, 0, 0, 0, 0, 0, 0], 
[0, 0, 0, 0, 0, 0, 0, 0, 0, 0, 0, 0, 0, 0, 0, 0, 0, 0, 0, 0, 0], 
[0, 0, 0, 0, 0, 0, 0, 0, 0, 0, 0, 0, 0, 0, 0, 0, 0, 0, 0, 0, 0]
],
"b": 3
}